######1#
#      #
#  *  *#
# #    #
# # #  #
### ####
