######1#
#   *  #
#  *   #
## #  *#
## #*  #
##    ##
